00000000000000000000
01122121012222212210
02020120210020010100
02212221201212222220
01020110212020012210
02222121021121122020
01020020010200220110
02210110212211222200
00220121202020102110
02221222212222210220
02122001001220121120
02021220211010012010
00000000000000000000